                    
                    
     #####          
     #...#          
     #$..#          
   ###..$##         
   #..$.$.#         
 ###.#.##.#   ##### 
 #...#.##.#####.oo# 
 #.$..$.........oo# 
 #####.###.#@##.oo# 
     #.....######## 
     #######        
                    
                    
