                    
                    
     #####          
     #...#          
     #$..#          
   ###..$##         
   #..$.$.#         
 ###.#.##.#  ###### 
 #...#.##.####..oo# 
 #.$..$.........oo# 
 #####.###.#@#..oo# 
     #.....######## 
     #######        
                    
                    
